kc kc kc kc kc kc kc kc kc kc
kc kc kc fb fb fb kc kc kc kc
kc kc kc fb fb fb kc kc kc kc
kc kc kc lc lc lc kc kc kc kc
kc kc kc kc kc kc kc kc kc kc